1110101000000100100100101010010
0000100100100S00011000100011111
1111110000000000000000011111001
0101010001001010100101010101000
1111110000111111000000011110001
0011111000000111111100100011010
0E00110111011000010010011100000
0101110000010100011110000111110
0000000011111110000010101001010