111111111111111
1S0000010000001
101111010111101
100001000100001
111101111101111
100000000000001
101110111011101
101000101000101
101110111011101
100000000000001
111101111101111
100001000100001
101111010111101
1000000100000E1
111111111111111